! 2 = TileDirt
! 1 = TileOcean
2          2
2          2
2          2
2          2
2    5     2
2          2
2          2
2          2
2          2
2          2
2      5   2
2          2
22         2
222        2
22         2
2         22
2        222
2         22
2          2
2    5     2
2          2
2          2
2          2
2          2
2          2
2          2
2          2
2       5  2
2          2
2          2
2          2
2          2
2          2
2          2
2          2
2          2
2          2
2         22
2        222
2        222
2        222
2       2222
22        22
2222      22
2222       2
22222      2
2222       2
222      222
222     2222
22      2222
2      22222
2        222
2         22
2          2
2          2
2          2
2          2
2          2
2          2
2          2
2          2
2          2
2          2
2          2
2          2
2          2
2          2
2          2
2          2
2          2
2          2
2          2
2          2
2          2
2          2
2          2
2          2
2          2
2          2
2          2
2          2
2          2
2          2
2          2
2          2
2          2
2          2
2          2
2          2
2          2
2          2
2          2
2          2
2          2
2          2
2          2
2          2
2          2
2          2
2          2
2          2
2          2
2          2
2          2
2          2
2          2
2          2
2          2
2          2
2          2
2          2
2          2
2          2
2          2
2          2
2          2
2          2
2          2
2          2
2          2
2          2
2          2
2          2
2          2
2          2
2          2
2          2
2          2
2          2
2          2
2          2
2          2
2          2
2          2
2          2
2          2
2          2
2          2
2          2
2          2
2          2
2          2
2          2
2          2